11000000000000000000000000000000
11000000000000000011100000000000
00000000000000000011100001111000
00000000000000000000000001111000
00000000000000000000000000000000
00000001100000011110000000000000
00000001100000011110000000000000
00000000000000011110000000000000
00000000000000011110000000000000
00000000000000000000000000000000
00000000000000000000000000000000
00000000000000000000000000000000
00000001100000000000000000000000
00000001100000000000000000000000
00000000000000000000000000000000
00000000000000000000000000000000
00000000000000000000000100000000
00000000000000000000000000000000
00000000000000000000000000000000
00001000000000000000000100000000
00000010000000000000000000000000
00000000000000000000000000000000
00001000000000000100000000000000
00000010000000000000000000000000
00000000000000000000010000100000
00001000000000000000000000000000
00000010000000000000000000000000
00000000000000000000000000000000
00000000000000000000000000000000
11111000000001111000000111100000
00000000000000000000000000000000
00000000000000000000000000000000